NO images/1.png

SO images/2.png

WE images/3.png

EA images/4.png

DO images/door.png

C 100, 100, 100
F 200, 200, 200

        1111111111111111111111111
        1000000000110000000000001
        1011000001110000000000001
        10010000000000000000000001
111111111011000001110000000000001
100000000011000001110111111111111
11110111111111011100000010001
11110111111111011101D10010001
11000000110110111000000100001
10000000000000001100000000001
10000000000000001101010010001
11000001110101011111011110N01
11110111 1110101 101111010001
11111111 1111111 111111111111