NO images/1.png

SO images/2.png

WE images/3.png

EA images/4.png

C 100, 100, 100
F 200, 200, 200

11111111111111111111111111111111111
10000000000000000000001111111111111
10000000000000010000000010000000001
100000000000000000D0000WD00111110001
10000000000000000000000010001000111
10000000000010000000000011111111111
1000000000000000000000001
1000000000000000000000001
1000000000000000000000001
1000000000000000000000001
1111111111111111111111111
