NO images/BRICK_1A.PNG

SO images/BRICK_2B.PNG

WE images/BRICK_3B.PNG

EA images/BRICK_3D.PNG

C 100, 100, 100
F 200, 200, 200

        1111111111111111111111111
        1000000000110000000000001
        1011000001110000000000001
        10010000000000000000000001
111111111011000001110000000000001
10000000001100000111011111111111
11110111111111010100000010001
11110111111111011101010010001
11000000110111111000000100001
10000000000000000100000000001
10000000000000001101010010001
11000001110101011111011110W01
11110111 1110101 101111010001
11111111 1111111 111111111111
