NO images/CRATE_1E.PNG

SO images/CRATE_2M.PNG

WE images/CRATE_2C.PNG

EA images/DOOR_1A.PNG

C 39, 110, 245
F 132, 118, 106

        1111111111111111111111111
        1000000000110000000000001
        1011000001110000000000001
        10010000000000000000000001
111111111011000001110000000000011111
1000000000110000011101111111111
11110111111111011100000010001
11110111111111011101010010001
11000000110110111000000100001
10000000000000001100000000001
100000000000000011010100100011
11000001110101011111011110S01
11110111 1110101 101111010001
11111111 1111111 111111111111
